4 4 4 4 4 4 4 4 4 4 4 4 4 4 4 4 4 4 4 4 4 4 4 4 4 4 4 4 4 4 4 4 4 4 4 4 4 4 4 4 4 4 4 4 4 4 4 4 4 4 
4 11 14 14 14 14 14 14 14 14 14 14 14 12 4 4 4 4 4 11 14 14 14 14 14 14 14 12 4 4 4 4 4 4 4 4 4 4 4 4 4 4 4 4 4 4 4 4 4 4
4 10 0 0 0 0 0 0 0 0 0 0 0 9 4 4 4 4 4 10 0 0 0 0 0 0 0 9 4 4 4 4 4 4 4 4 4 4 4 4 4 4 4 4 4 4 4 4 4 4 
4 10 0 0 0 0 0 0 0 0 0 0 0 9 4 4 4 4 4 10 0 0 0 0 0 0 0 9 4 4 4 4 4 4 4 4 4 4 4 4 4 4 4 4 4 4 4 4 4 4 
4 10 0 0 0 0 0 0 6 7 7 7 7 17 4 4 4 4 4 10 0 0 0 0 0 0 0 9 4 4 4 4 4 4 4 4 4 4 4 4 4 4 4 4 4 4 4 4 4 4 
4 16 8 0 6 7 7 7 17 4 4 4 4 4 4 4 4 4 4 10 0 0 0 0 0 0 0 9 4 4 4 4 4 4 4 4 4 4 4 4 4 4 4 4 4 4 4 4 4 4 
4 4 10 0 9 4 4 4 1 1 1 1 1 4 4 4 4 4 4 10 0 0 0 0 0 0 0 9 4 4 4 4 11 14 14 14 14 14 14 14 14 12 4 4 4 4 4 4 4 4 
4 4 10 0 9 4 4 4 1 3 3 3 1 4 4 4 4 4 4 10 0 0 0 0 0 0 0 9 4 4 4 4 10 0 0 0 0 0 0 0 0 13 12 4 4 4 4 4 4 4 
4 4 10 0 9 4 4 4 1 3 3 3 1 4 4 4 4 4 4 16 8 0 0 0 0 0 6 17 4 4 4 4 16 8 0 0 0 0 0 0 0 0 9 4 4 4 4 4 4 4 
4 4 10 0 13 14 12 4 1 3 3 3 1 4 4 4 4 4 4 4 16 8 0 0 0 6 17 4 4 4 4 4 4 10 0 0 0 0 0 0 0 0 9 4 4 4 4 4 4 4 
4 4 10 0 0 0 9 4 1 3 3 3 1 4 4 4 4 4 4 4 4 16 8 0 6 17 4 4 4 4 4 4 4 10 0 0 0 0 0 0 0 0 9 4 4 4 4 4 4 4 
4 4 10 0 0 0 9 4 1 1 3 1 1 4 4 4 4 4 4 4 4 4 19 0 18 4 4 4 4 4 4 4 4 10 0 0 0 0 0 0 0 0 9 4 4 4 4 4 4 4 
4 4 10 0 6 7 17 4 4 10 0 9 4 4 4 4 4 4 4 4 4 4 10 0 9 4 4 4 4 4 4 4 4 16 8 0 0 0 0 0 0 6 17 4 4 4 4 4 4 4 
4 4 10 0 9 4 4 4 4 10 0 9 4 4 4 4 4 4 4 4 4 4 10 0 9 4 4 4 4 4 4 4 4 4 16 7 7 8 0 6 7 17 4 4 4 4 4 4 4 4 
4 4 10 0 9 4 4 4 4 10 0 9 4 4 4 4 4 4 4 4 4 4 10 0 9 4 4 4 4 4 4 4 4 4 4 4 4 10 0 9 4 4 4 4 4 4 4 4 4 4 
4 4 19 0 18 4 4 11 14 15 0 9 4 4 4 4 4 4 4 4 4 4 10 0 9 4 4 4 4 4 4 4 4 4 4 4 4 19 0 18 4 4 4 4 4 4 4 4 4 4 
4 4 10 0 13 14 14 15 0 0 0 9 4 4 4 4 4 4 4 4 4 4 10 0 9 4 4 4 4 4 4 4 4 4 4 4 4 10 0 9 4 4 4 4 4 4 4 4 4 4 
4 4 10 0 0 0 0 0 0 6 7 17 4 4 4 4 4 4 4 4 4 11 15 0 13 12 4 4 4 4 4 4 4 4 4 11 14 15 0 9 4 4 4 4 4 4 4 4 4 4 
4 4 16 7 7 7 7 8 0 9 4 4 4 4 4 4 4 4 4 4 11 15 0 0 0 13 12 4 4 4 4 4 4 4 4 10 0 0 0 9 4 4 4 4 4 4 4 4 4 4 
4 4 4 4 4 4 4 10 0 9 4 4 4 4 4 4 4 4 4 11 15 0 0 0 0 0 13 12 4 4 4 4 4 4 11 15 0 6 7 17 4 4 4 4 4 4 4 4 4 4 
4 4 4 4 4 4 4 10 0 9 4 11 14 14 14 14 14 14 14 15 0 0 0 0 0 0 0 13 14 14 14 14 14 14 15 0 0 9 4 4 4 4 4 4 4 4 4 4 4 4 
4 4 4 4 4 4 4 10 0 9 4 10 0 0 0 0 0 0 0 0 0 0 0 0 0 0 0 0 0 0 0 0 0 0 0 0 0 9 4 4 4 4 4 4 4 4 4 4 4 4 
4 4 4 4 4 4 4 10 0 9 4 10 0 6 7 7 7 7 7 8 0 0 0 0 0 0 0 6 7 7 7 7 7 7 7 8 0 9 4 4 4 4 4 4 4 4 4 4 4 4 
4 4 4 4 4 4 4 10 0 9 4 19 0 18 4 4 4 4 4 16 8 0 0 0 0 0 6 17 4 4 4 4 4 4 4 10 0 9 4 4 4 4 4 4 4 4 4 4 4 4 
4 4 4 4 4 4 4 10 0 9 4 10 0 13 14 12 4 4 4 4 16 8 0 0 0 6 17 4 4 4 4 4 4 4 4 10 0 9 4 4 4 4 4 4 4 4 4 4 4 4 
4 4 4 4 4 4 4 10 0 9 4 10 0 0 0 9 4 4 4 4 4 16 8 0 6 17 4 4 4 4 4 4 4 4 4 10 0 9 4 4 4 4 4 4 4 4 4 4 4 4 
4 4 4 4 4 4 4 10 0 9 4 16 7 8 0 9 4 4 4 4 4 4 10 0 9 4 4 4 4 4 4 4 4 4 4 10 0 9 4 4 4 4 4 4 4 4 4 4 4 4 
4 4 4 4 4 4 4 19 0 18 4 4 4 10 0 9 4 4 4 4 4 4 10 0 9 4 4 4 4 4 4 4 4 4 4 10 0 9 4 4 4 4 4 4 4 4 4 4 4 4 
4 4 4 4 4 4 4 10 0 13 14 14 14 15 0 9 4 4 4 4 4 4 10 0 9 4 4 4 4 4 4 4 4 4 4 10 0 9 4 4 4 4 4 4 4 4 4 4 4 4 
4 4 4 4 4 4 4 10 0 0 0 0 0 0 0 9 4 4 4 4 4 4 10 0 9 4 4 4 4 4 4 4 4 4 4 10 0 9 4 4 4 4 4 4 4 4 4 4 4 4 
4 4 4 4 4 4 4 10 0 0 0 0 0 0 0 9 4 4 4 4 4 4 10 0 9 4 4 4 4 4 4 4 4 4 11 15 0 13 12 4 4 4 4 4 4 4 4 4 4 4 
4 4 4 4 4 4 4 10 0 0 0 0 0 0 0 9 4 4 4 4 4 4 10 0 9 4 4 4 4 4 4 4 4 4 10 0 0 0 9 4 4 4 4 4 4 4 4 4 4 4 
4 4 4 4 4 4 4 10 0 0 0 0 0 0 0 9 4 4 4 4 4 4 10 0 9 4 4 4 4 4 4 4 4 4 10 0 0 0 9 4 4 4 4 4 4 4 4 4 4 4 
4 4 4 4 4 4 4 10 0 0 0 0 0 0 0 9 4 4 4 4 4 4 10 0 9 4 4 4 4 4 4 4 4 4 10 0 0 0 9 4 4 4 4 4 4 4 4 4 4 4 
4 4 4 4 4 4 4 10 0 0 0 0 0 0 0 9 4 4 4 4 4 4 10 0 9 4 4 4 4 4 4 4 4 4 10 0 0 0 9 4 4 4 4 4 4 4 4 4 4 4 
4 4 4 4 4 4 4 16 8 0 6 7 7 7 7 17 4 4 11 14 14 14 15 0 13 14 14 12 4 4 4 4 4 11 15 0 0 0 13 12 4 4 4 4 4 4 4 4 4 4 
4 4 4 4 4 4 4 4 10 0 9 4 4 4 4 4 4 11 15 0 0 0 0 0 0 0 0 13 12 4 4 4 11 15 0 0 0 0 0 9 4 4 4 4 4 4 4 4 4 4 
4 4 4 4 4 4 4 4 10 0 9 4 4 4 4 4 4 10 0 0 0 0 0 0 0 0 0 0 9 4 4 11 15 0 0 0 0 0 0 9 4 4 4 4 4 4 4 4 4 4 
4 11 14 14 14 14 14 14 15 0 9 4 4 4 4 4 4 10 0 0 0 0 0 0 0 0 0 0 9 4 4 10 0 0 0 0 0 0 0 9 4 4 4 4 4 4 4 4 4 4 
4 10 0 0 0 0 0 0 0 0 9 4 4 4 4 4 4 10 0 0 0 0 0 0 0 0 0 0 13 14 14 15 0 0 0 0 0 0 0 9 4 4 4 4 4 4 4 4 4 4 
4 10 0 0 0 0 0 6 7 7 17 4 4 4 4 4 4 10 0 0 0 0 0 0 0 0 0 0 0 0 0 0 0 0 0 0 0 0 0 9 4 4 4 4 4 4 4 4 4 4 
4 10 0 0 0 0 0 9 4 4 4 4 4 4 4 4 4 16 8 0 0 0 0 0 0 0 0 6 7 7 8 0 0 0 0 0 0 0 0 9 4 4 4 4 4 4 4 4 4 4 
4 10 0 0 0 0 0 9 4 4 4 11 14 14 14 14 14 12 16 8 0 0 0 0 0 0 6 17 4 4 10 0 0 0 0 0 0 0 0 9 4 4 4 4 4 4 4 4 4 4 
4 10 0 0 0 0 0 9 4 4 4 10 0 0 0 0 0 9 4 16 8 0 6 7 7 7 17 4 4 4 16 8 0 0 0 0 0 0 6 17 4 4 4 4 4 4 4 4 4 4 
4 10 0 0 0 0 0 9 4 4 4 10 0 0 0 0 0 9 4 4 10 0 9 4 4 4 4 4 4 4 4 16 7 7 7 7 7 7 17 4 4 4 4 4 4 4 4 4 4 4 
4 10 0 0 0 0 0 9 4 4 4 10 0 0 0 0 0 13 12 4 10 0 9 4 4 4 4 4 4 4 4 4 4 4 4 4 4 4 4 4 4 4 4 4 4 4 4 4 4 4 
4 16 8 0 0 6 7 17 4 4 4 10 0 0 0 0 0 0 13 14 15 0 9 4 4 4 4 4 4 4 4 4 4 4 4 4 4 4 4 4 4 4 4 4 4 4 4 4 4 4 
4 4 10 0 0 9 4 4 4 4 4 16 7 7 7 7 8 0 0 0 0 0 9 4 4 4 4 4 4 4 4 4 4 4 4 4 4 4 4 4 4 4 4 4 4 4 4 4 4 4 
4 4 16 7 7 17 4 4 4 4 4 4 4 4 4 4 4 7 7 7 7 7 4 4 4 4 4 4 4 4 4 4 4 4 4 4 4 4 4 4 4 4 4 4 4 4 4 4 4 4 
4 4 4 4 4 4 4 4 4 4 4 4 4 4 4 4 4 4 4 4 4 4 4 4 4 4 4 4 4 4 4 4 4 4 4 4 4 4 4 4 4 4 4 4 4 4 4 4 4 4 