4 4 4 4 4 4 4 4 4 4 4 4 4 4 4 4 4 4 4 4 4 4 4 4 4 4 4 4 4 4 4 4 4 4 4 4 4 4 4 4 4 4 4 4 4 4 4 4 4 4 
4 4 14 14 14 14 14 14 14 14 14 14 14 4 4 4 4 4 4 4 14 14 14 14 14 14 14 4 4 4 4 4 4 4 4 4 4 4 4 4 4 4 4 4 4 4 4 4 4 4
4 10 0 0 0 0 0 0 0 0 0 0 0 9 4 4 4 4 4 10 0 0 0 0 0 0 0 9 4 4 4 4 4 4 4 4 4 4 4 4 4 4 4 4 4 4 4 4 4 4 
4 10 0 0 0 0 0 0 6 8 0 0 0 9 4 4 4 4 4 10 0 0 0 0 0 0 0 9 4 4 4 4 4 4 4 4 4 4 4 4 4 4 4 4 4 4 4 4 4 4 
4 10 0 0 0 0 0 0 9 4 7 7 7 4 4 4 4 4 4 10 0 0 0 0 0 0 0 9 4 4 4 4 4 4 4 4 4 4 4 4 4 4 4 4 4 4 4 4 4 4 
4 4 8 0 6 7 7 7 4 4 4 4 4 4 4 4 4 4 4 10 0 0 0 0 0 0 0 9 4 4 4 4 4 4 4 4 4 4 4 4 4 4 4 4 4 4 4 4 4 4 
4 4 10 0 9 4 4 4 1 1 1 1 1 4 4 4 4 4 4 10 0 0 0 0 0 0 0 9 4 4 4 4 4 14 14 14 14 14 14 14 14 4 4 4 4 4 4 4 4 4 
4 4 10 0 9 4 4 4 1 3 3 3 1 4 4 4 4 4 4 10 0 0 0 0 0 0 0 9 4 4 4 4 10 0 0 0 0 0 0 0 0 13 4 4 4 4 4 4 4 4 
4 4 10 0 9 4 4 4 1 3 3 3 1 4 4 4 4 4 4 4 8 0 0 0 0 0 6 4 4 4 4 4 4 8 0 0 0 0 0 0 0 0 9 4 4 4 4 4 4 4 
4 4 10 0 13 14 4 4 1 3 3 3 1 4 4 4 4 4 4 4 4 8 0 0 0 6 4 4 4 4 4 4 4 10 0 0 0 0 0 0 0 0 9 4 4 4 4 4 4 4 
4 4 10 0 0 0 9 4 1 3 3 3 1 4 4 4 4 4 4 4 4 4 8 0 6 4 4 4 4 4 4 4 4 10 0 0 0 0 0 0 0 0 9 4 4 4 4 4 4 4 
4 4 10 0 0 0 9 4 1 1 0 1 1 4 4 4 4 4 4 4 4 4 4 0 4 4 4 4 4 4 4 4 4 10 0 0 0 0 0 0 0 0 9 4 4 4 4 4 4 4 
4 4 10 0 6 7 4 4 4 10 0 9 4 4 4 4 4 4 4 4 4 4 10 0 9 4 4 4 4 4 4 4 4 4 8 0 0 0 0 0 0 6 4 4 4 4 4 4 4 4 
4 4 10 0 9 4 4 4 4 10 0 9 4 4 4 4 4 4 4 4 4 4 10 0 9 4 4 4 4 4 4 4 4 4 4 7 7 8 0 6 7 4 4 4 4 4 4 4 4 4 
4 4 10 0 9 4 4 4 4 10 0 9 4 4 4 4 4 4 4 4 4 4 10 0 9 4 4 4 4 4 4 4 4 4 4 4 4 10 0 9 4 4 4 4 4 4 4 4 4 4 
4 4 4 0 4 4 4 4 14 15 0 9 4 4 4 4 4 4 4 4 4 4 10 0 9 4 4 4 4 4 4 4 4 4 4 4 4 4 0 4 4 4 4 4 4 4 4 4 4 4 
4 4 10 0 13 4 4 15 0 0 0 9 4 4 4 4 4 4 4 4 4 4 10 0 9 4 4 4 4 4 4 4 4 4 4 4 4 10 0 9 4 4 4 4 4 4 4 4 4 4 
4 4 10 0 0 0 0 0 0 6 7 4 4 4 4 4 4 4 4 4 4 4 15 0 13 4 4 4 4 4 4 4 4 4 4 4 14 15 0 9 4 4 4 4 4 4 4 4 4 4 
4 4 4 7 7 7 7 8 0 9 4 4 4 4 4 4 4 4 4 4 4 15 0 0 0 13 4 4 4 4 4 4 4 4 4 10 0 0 0 9 4 4 4 4 4 4 4 4 4 4 
4 4 4 4 4 4 4 10 0 9 4 4 4 4 4 4 4 4 4 4 15 0 0 0 0 0 13 4 4 4 4 4 4 4 4 10 0 6 7 4 4 4 4 4 4 4 4 4 4 4 
4 4 4 4 4 4 4 10 0 9 4 4 14 14 14 14 14 14 14 15 0 0 0 0 0 0 0 13 14 14 14 14 14 14 15 0 0 9 4 4 4 4 4 4 4 4 4 4 4 4 
4 4 4 4 4 4 4 10 0 9 4 10 0 0 0 0 0 0 0 0 0 0 0 0 0 0 0 0 0 0 0 0 0 0 0 0 0 9 4 4 4 4 4 4 4 4 4 4 4 4 
4 4 4 4 4 4 4 10 0 9 4 10 0 6 7 7 7 7 7 8 0 0 0 0 0 0 0 6 7 7 7 7 7 7 7 8 0 9 4 4 4 4 4 4 4 4 4 4 4 4 
4 4 4 4 4 4 4 10 0 9 4 4 0 4 4 4 4 4 4 4 8 0 0 0 0 0 6 4 4 4 4 4 4 4 4 10 0 9 4 4 4 4 4 4 4 4 4 4 4 4 
4 4 4 4 4 4 4 10 0 9 4 10 0 13 14 4 4 4 4 4 4 8 0 0 0 6 4 4 4 4 4 4 4 4 4 10 0 9 4 4 4 4 4 4 4 4 4 4 4 4 
4 4 4 4 4 4 4 10 0 9 4 10 0 0 0 9 4 4 4 4 4 4 8 0 6 4 4 4 4 4 4 4 4 4 4 10 0 9 4 4 4 4 4 4 4 4 4 4 4 4 
4 4 4 4 4 4 4 10 0 9 4 4 7 8 0 9 4 4 4 4 4 4 10 0 9 4 4 4 4 4 4 4 4 4 4 15 0 9 4 4 4 4 4 4 4 4 4 4 4 4 
4 4 4 4 4 4 4 4 0 4 4 4 4 10 0 9 4 4 4 4 4 4 10 0 9 4 4 0 4 4 4 4 4 4 10 0 0 9 4 4 4 4 4 4 4 4 4 4 4 4 
4 4 4 4 4 4 4 10 0 13 14 14 14 15 0 9 4 4 4 4 4 4 10 0 9 4 4 4 4 4 0 4 4 4 4 8 0 9 4 4 4 4 4 4 4 4 4 4 4 4 
4 4 4 4 4 4 4 10 0 0 0 0 0 0 0 9 4 4 4 4 4 4 10 0 9 4 4 4 4 4 0 4 4 4 4 10 0 9 4 4 4 4 4 4 4 4 4 4 4 4 
4 4 4 4 4 4 4 10 0 0 0 0 0 0 0 9 4 4 4 4 4 4 10 0 9 4 4 4 4 4 4 4 4 4 4 15 0 13 4 4 4 4 4 4 4 4 4 4 4 4 
4 4 4 4 4 4 4 10 0 0 0 0 0 0 0 9 4 4 4 4 4 4 10 0 9 4 4 4 4 4 4 4 4 4 10 0 0 0 9 4 4 4 4 4 4 4 4 4 4 4 
4 4 4 4 4 4 4 10 0 0 0 0 0 0 0 9 4 4 4 4 4 4 10 0 9 4 4 4 4 4 4 4 4 4 10 0 0 0 9 4 4 4 4 4 4 4 4 4 4 4 
4 4 4 4 4 4 4 10 0 0 0 0 0 0 0 9 4 4 4 4 4 4 10 0 9 4 4 4 4 4 4 4 4 4 10 0 0 0 9 4 4 4 4 4 4 4 4 4 4 4 
4 4 4 4 4 4 4 10 0 0 0 0 0 0 0 9 4 4 4 4 4 4 10 0 9 4 4 4 4 4 4 4 4 4 10 0 0 0 9 4 4 4 4 4 4 4 4 4 4 4 
4 4 4 4 4 4 4 4 8 0 6 7 7 7 7 4 4 4 4 14 14 14 15 0 13 14 14 4 4 4 4 4 4 4 10 0 0 0 9 4 4 4 4 4 4 4 4 4 4 4 
4 4 4 4 4 4 4 4 10 0 9 4 4 4 4 4 4 4 15 0 0 0 0 0 0 0 0 13 4 4 4 4 4 15 0 0 0 0 0 9 4 4 4 4 4 4 4 4 4 4 
4 4 4 4 4 4 4 4 10 0 9 4 4 4 4 4 4 10 0 0 0 0 0 0 0 0 0 0 9 4 4 4 15 0 0 0 0 0 0 9 4 4 4 4 4 4 4 4 4 4 
4 4 14 14 14 14 14 14 15 0 9 4 4 4 4 4 4 10 0 0 0 0 0 0 0 0 0 0 9 4 4 10 0 0 0 0 0 0 0 9 4 4 4 4 4 4 4 4 4 4 
4 10 0 0 0 0 0 0 0 0 9 4 4 4 4 4 4 10 0 0 0 0 0 0 0 0 0 0 13 14 14 15 0 0 0 0 0 4 0 9 4 4 4 4 4 4 4 4 4 4 
4 10 0 0 0 0 0 6 7 7 4 4 4 4 4 4 4 10 0 0 0 0 0 0 0 0 0 0 0 0 0 0 0 0 4 0 0 0 0 9 4 4 4 4 4 4 4 4 4 4 
4 10 0 0 0 0 0 9 4 4 4 4 4 4 4 4 4 4 8 0 0 0 0 0 0 0 0 6 7 7 8 0 0 0 0 0 0 0 0 9 4 4 4 4 4 4 4 4 4 4 
4 10 0 0 0 0 0 9 4 4 4 4 14 14 14 14 14 4 4 8 0 0 0 0 0 0 6 4 4 4 10 0 0 4 0 0 4 0 0 9 4 4 4 4 4 4 4 4 4 4 
4 10 0 0 0 0 0 9 4 4 4 10 0 0 0 0 0 9 4 4 8 0 6 7 7 7 4 4 4 4 4 8 0 0 0 0 0 0 9 4 4 4 4 4 4 4 4 4 4 4 
4 10 0 0 0 0 0 9 4 4 4 10 0 0 0 0 0 9 4 4 10 0 9 4 4 4 4 4 4 4 4 4 7 7 7 7 7 7 4 4 4 4 4 4 4 4 4 4 4 4 
4 10 0 0 0 0 0 9 4 4 4 10 0 0 0 0 0 13 4 4 10 0 9 4 4 4 4 4 4 4 4 4 4 4 4 4 4 4 4 4 4 4 4 4 4 4 4 4 4 4 
4 4 8 0 0 6 7 4 4 4 4 10 0 0 0 0 0 0 13 14 15 0 9 4 4 4 4 4 4 4 4 4 4 4 4 4 4 4 4 4 4 4 4 4 4 4 4 4 4 4 
4 4 10 0 0 9 4 4 4 4 4 4 7 7 7 7 8 0 0 0 0 0 9 4 4 4 4 4 4 4 4 4 4 4 4 4 4 4 4 4 4 4 4 4 4 4 4 4 4 4 
4 4 4 7 7 4 4 4 4 4 4 4 4 4 4 4 4 7 7 7 7 7 4 4 4 4 4 4 4 4 4 4 4 4 4 4 4 4 4 4 4 4 4 4 4 4 4 4 4 4 
4 4 4 4 4 4 4 4 4 4 4 4 4 4 4 4 4 4 4 4 4 4 4 4 4 4 4 4 4 4 4 4 4 4 4 4 4 4 4 4 4 4 4 4 4 4 4 4 4 4 